NO ./textures/wall_1.xpm
SO ./textures/wall_2.xpm
WE ./textures/wall_3.xpm
EA ./textures/wall_4.xpm

S0 ./textures/soul_tree.xpm
S1 ./textures/sphere.xpm
S2 ./textures/barrel.xpm
S3 ./textures/tree.xpm
S4 ./textures/zombie.xpm
S5 ./textures/gargoyle.xpm
S6 ./textures/phantasm.xpm
S7 ./textures/alien.xpm

E0:4:29:9:4:5:10
E1:5:18:3:5:3:6
E2:6:19:0:4:5:9
E3:7:21:8:4:3:5

WT ./textures/kosy.xpm
DT ./textures/door.xpm

F 30,30,30
C 19,15,51

1111111111111111111111111111111111111111111111111111111111111111111111111111111111111111111111111
1000000000000000000000000000000111130000000000000000000000000000914000000000000000000000000000041
1000000000000000000000000000000111100000000500020050000500000000010000000000000005000000000500001
1000000000000000000000000000000111100000000000000000000000000000010000000000000000000000000005001
10000000000000000000000000000001111000020000000020000000000000000D0000000000000000000000000000041
1000000000000000000000000000000111100000000000000000000020000000011111111111111111111111D111111111
1000000000000000000000000000000111100005000000000000000000005000013000000000000000000000000000031
1000000000000000000000000000000111130000000000000000000000000000310000000000000000050000000050001
11111111111111111111111111111111111111111111D1111111111111111111110000000000000000000000000000001
1000000000000000000000000000002111140000020000000000000030000000410000000000000000000000000000001
1000000000000000000000000000003111100000002000000000500000000070010000000020002000000000000020001
1000000000000050500000500000000110000000000000000000000000000002010000000000000000000000000000001
10000000000W0000000000000000000D000000000000000000000000000000000D0000000020000000000000000000001
1000000000000000000000000000000110000000000000000000500000000000010000000000000000000000000002001
1000000000000050500000500000003111000000002000000000000020000000010000000000000000000000000000001
1000000000000000000000000000002111400000000000000300000000000000413000000000000000000000080000031
11111111111111111111111111111111111111111111D1111111111111111111111111111111111111111111111111111
100000000000000000000000000000011114000000000000000000000000000041
100000000000000000000000000000011110000000000000000000000000002001
100000000000000000000000000000011110000000000000000000000000000001
100000000000000000000000000000011110040000000000000000000040000001
100000000000000000000000000000011110040000000000000000000040000001
100000000000000000000000000000011110000000000000000000000000002001
100000000000000000000000000000011110000000000000000000000000000001
100000000000000000000000000000011110040000000000000000000040000001
100000000000000000000000000000011110000000000000000000000000200001
100000000000000000000000000000011110040000000000000000000000000001
100000000000000000000000000000011110000000000000000000000040000001
100000000000000000000000000000011110000000000000000000000000000001
100000000000000000000000000000011110040000000060000000000020000001
100000000000000000000000000000011110000000000000000000000000000001
100000000000000000000000000000011110000000000000000000000040000001
100000000000000000000000000000011115000000000000000000000000000041
111111111111111111111111111111111111111111111111111111111111111111
