NO ./textures/greystone.xpm
SO ./textures/mnstr.xpm
WE ./textures/stch.xpm
EA ./textures/greystone.xpm

F 127,0,127
C 0,127,127

111111111111111111111111
111000100000001000000011
100000100000000100000111
100000100000000100000111
100000100000000100000111
111110100000000100000111
10000010000000W111110111
100000111111110100000111
100000000000000100000111
101111111111111100000111
100000000000000100000011
100000000000000100000011
100000000000010000000011
111111111101100000000011
111100000000000100000011
100000000000000000000011
100000000000000000000011
111111111111111110111111
111111111111111110111111
100010010000100100010111
100000000000000000001011
100000000000000000001001
100000000000000000000011
111113331112221111111111
