NO ./textures/mnstr.xpm
SO ./textures/purplestone.xpm
WE ./textures/redbrick.xpm
EA ./textures/mossy.xpm

S0 ./textures/kj.xpm
S1 ./textures/reyna.xpm
S2 ./textures/barrel.xpm
S3 ./textures/pillar.xpm
S4 ./textures/Zombie.xpm
S5 ./textures/Gargoyle.xpm
S6 ./textures/Phantasm.xpm
S7 ./textures/Alien.xpm

E0:4:29:9:4:5:10
E1:5:18:3:5:3:6
E2:6:19:0:4:5:9
E3:7:21:5:7:3:5

F 127,0,127
C 0,127,127

111111111111111111111111
111000100000051000000011
100000100000400100000111
100000100003000100000111
100000100020000100000111
1111101000006001000001111111111111111111111111111111111111111111111111111111
100000100700000S0000000000000000000000000000000000000000000000000000000000001
10000011111111000000000000000000000000000000000000000700000000000000000000001
10000000000000010000000000000000000000009000000000000000080000000000000000001
10111111111111110000000000000000000000000000000000000000000000000000000000001
10000000000000010000001000000000000000000000000000000000000060000000000000001
10000000000000010554301111111111111111111111111111000000000000000000000000001
100000000000010000000011                         1000000000000000000000000001
111111111101100000060011                         1000000000000000000000000001
111100000000000100000011                         1000000000000000000000000011
100000000000000000000011                         1000000000000000000000000001
100000000000000000000011                         1000000000000000000000000001
111111111111111110111111                         1000000000000000000000000001
111111111111111110111111                         1000000000000000000000000001
100010010000100100010111                         1111111111111111111111111111
100000000000000000001011
100000000000000000001001
100000000000000000000011
11111111111111111111111
