NO ./textures/mnstr.xpm
SO ./textures/purplestone.xpm
WE ./textures/redbrick.xpm
EA ./textures/mossy.xpm

S0 ./textures/kj.xpm
S1 ./textures/reyna.xpm
S2 ./textures/barrel.xpm
S3 ./textures/pillar.xpm
S4 ./textures/Zombie.xpm
S5 ./textures/Gargoyle_v2.xpm
S6 ./textures/Phantasm.xpm
S7 ./textures/Alien_v2.xpm

E0:4:29:9:4:5:10
E1:5:18:3:5:3:6
E2:6:19:0:4:5:9
E3:7:21:8:4:3:5

F 127,0,127
C 0,127,127

111111111111111111111111
111000100000051000000011
111111111111111111111111
100000100003000100000111
100000100020000100000111
1111101000000001000001111111111111111111111111111111111111111111111111111111
100000100000000W0000000100000000000000000000000000000000000000000000000000001
10000011111111000000000000000007000000000000000000000000000000000000000000001
10000000000000010000000100000000000000009000000000000000080000000000000000001
10111111111111110000000100000000000000000000000000000000000000000000000000001
10000000000000010000001100000000000000000000000000000000000060000000000000001
10000000000000010554301111111111111111111111111111000000000000000000000000001
100000000000010000000011                         1000000000000000000000000001
111111111101100000000011                         1000000000000000000000000001
111100000000000100000011                         1000000000000000000000000011
100000000000000000000011                         1000000000000000000000000001
100000000000000000000011                         1000000000000000000000000001
111111111111111110111111                         1000000000000000000000000001
111111111111111110111111                         1000000000000000000000000001
100010010000100100010111                         1111111111111111111111111111
100000000000000000001011
100000000000000000001001
100000000000000000000011
111111111111111111111111
