NO ./textures/greystone.xpm
SO ./textures/purplestone.xpm
WE ./textures/redbrick.xpm
EA ./textures/mossy.xpm

S0 ./textures/kj.xpm
S1 ./textures/reyna.xpm
S2 ./textures/barrel.xpm
S3 ./textures/pillar.xpm
S4 ./textures/greenlight.xpm
S5 ./textures/ghost.xpm
S6 ./textures/hamster.xpm
S7 ./textures/mario.xpm

F 127,0,127
C 0,127,127

111111111111111111111111
111000100000051000000011
100000100000400100000111
100000100003000100000111
100000100020000100000111
11111010000060010000011111111111111111111111111111111111111111111111111111111
10000010070000W00000000000000000000000000000000000000000000000000000000000001
10000011111111000000000000000000000000000000000000000000000000000000000000001
10000000000000010000000000000000000000000000000000000000000000000000000000001
10111111111111110000000000000000000000000000000000000000000000000000000000001
10000000000000010000001000000000000000000000000000000000000000000000000000001
10000000000000010554301111111111111111111111111111000000000000000000000000001
100000000000010000000011						 1000000000000000000000000001
111111111101100000060011						 1000000000000000000000000001
111100000000000100000011						 1000000000000000000000000001
100000000000000000000011						 1000000000000000000000000001
100000000000000000000011						 1000000000000000000000000001
111111111111111110111111						 1000000000000000000000000001
111111111111111110111111						 1000000000000000000000000001
100010010000100100010111						 1111111111111111111111111111
100000000000000000001011
100000000000000000001001
100000000000000000000011
111111111111111111111111
