NO ./textures/g_wall.xpm
SO ./textures/f_wall.xpm
WE ./textures/file.xpm
EA ./textures/red_hd_wall.xpm

S0 ./textures/soul_tree.xpm
S1 ./textures/sphere.xpm
S2 ./textures/barrel.xpm
S3 ./textures/tree_v2.xpm
S4 ./textures/Zombie_v5.xpm
S5 ./textures/Gargoyle_v3.xpm
S6 ./textures/Phantasm_v3.xpm
S7 ./textures/Alien_v3.xpm

E0:4:29:9:4:5:10
E1:5:18:3:5:3:6
E2:6:19:0:4:5:9
E3:7:21:8:4:3:5

W ./textures/kosy_res.xpm

D ./textures/door.xpm

F 30,30,30
C 19,15,51

        111111111111111111111111
        1000000000110000000000001
        1011000001110060708090001
        1001000000000000000000001
111111111011000001110000000000001
100000000011000001110111110111111
11110111111111011100000010001
11110111111111011101010010001
11000000110101011100000040001
10000000000000001100000030001
10000000000000001101010020001
11000001110101011111011110N0111
11110111 1110101 101111010001
11111111 1111111 111111111111
