NO ./textures/greystone.xpm
SO ./textures/purplestone.xpm
WE ./textures/redbrick.xpm
EA ./textures/mossy.xpm

S0 ./textures/kj.xpm
S1 ./textures/reyna.xpm
S2 ./textures/barrel.xpm
S3 ./textures/pillar.xpm
S4 ./textures/greenlight.xpm
S5 ./textures/ghost.xpm
S6 ./textures/hamster.xpm
S7 ./textures/mario.xpm

F 127,0,127
C 0,127,127

111111111111111111111111
111000100000051000000011
100000100000400100000111
100000100003000100000111
100000100020000100000111
111110100000600100000111
10000010070000W000000001
100000111111110000000001
100000000000000100000001
101111111111111100000001
100000000000000100000011
100000000000000105543011
100000000000010000000011
111111111101100000060011
111100000000000100000011
100000000000000000000011
100000000000000000000011
111111111111111110111111
111111111111111110111111
100010010000100100010111
100000000000000000001011
100000000000000000001001
100000000000000000000011
111111111111111111111111
