NO ./path_to_the_north_texture
SO ./path_to_the_south_texture
WE ./path_to_the_west_texture
EA ./path_to_the_east_texture

F 255,0,255
C 0,255,255

111111111111111111111111111111111111111111111
11100010000000100000000000100000000000100001
100000100000000100000100000100000000000100001
100000100000000100000100000100000000000111111
1000001000000001000001000001011111111111
1111101000000001000001000001000000000001
1000001000000001111101000001000000000001
1000001111111101000001000001000000000001
1000000000000001000001000001000000000001
1011111111111111000001111101000000000001
1000000000000001000000000001111111111011
1000000000000001000000000001000000000001
1000000000000001000000000001000000000001
1111111111011111000000000001000000000001
11110000000000010000000000010000000000011
1000000000000000000000000001000000000001
1000000000000000000000000001000000000001
1111111111111111111111111101000000000001
1111111111111111111111111101011111111101
1000001000000001000000000001000000000001
1000001000000001000001000001000000000001
1000001000000001000000000001000000000001
1000001000000001000000000001000000000001
111110100000000100000000N001010000000001
1000001000000001000000000001001000000001
1000001111111101000000000001000100000001
1000000000000001000000000001000010000001
1011111111111111000000000001000001000001
1000000000000001000000000001000000100001
1000000000000001000000000001000000010001
1000000000000001000000000001000000001001
111111111101111100000000001000000000101
1111000000000010000000000010000000000101111111111
11111111000000000010001000000000011000000000001
1000000000000000001000100000000000001111111111111
1000000000000000001000100000000000001
100000000000000000000000000000000001111111111111
100000000000000000000000000000000001
100000000000000001111110000000000001
1000000000000011100000011000000000011
10000000000001110000000011100000000001
10000000000011100000000001111000000001
 10000000000000000000000000000000000001
1111111111111111111111111111111111110001
                                    10001
                                    100001
                                    1000001
                                    10000001
                                    100000001
                                    1111111111
